A$	澳元
AED	阿联酋迪拉姆
ARS	阿根廷比索
AUD	澳元
CAD$	加元
CAD	加元
CHF	瑞士法郎
CNY	人民币
EUR	欧元成员国
GBP	英镑
HK＄	港元
HKD	港元
INR	印度卢比
J￥	日元
JPY￥	日元
JPY	日元
KRW	韩元
RUB	俄罗斯卢布
SAR	沙特阿拉伯里亚尔
SEK	瑞典克朗
SGD	新加坡元
THB	泰铢
TRY	土耳其里拉
USD	美元
